111111111111111111111111
1P0000000C00111111100001
1000010000001C0000000001
1000C1100000111111100001
100011110000000000000001
10011110000000C000000001
100011000010000000000C01
100100000110100001111111
1000000e11111110000000E1
111111111111111111111111