11111111111111
1000100C00P001
100000010000C1
10000011100001
1C0001111100E1
11111111111111
