30123
111111111111111111112111111221
111111111111111111111111211111
111121111111121111111112111111
121111111111211211111111111111
111111121111111111111111111221
111111111121111111211112111111
111111111111111111111111111111
111111111111111111111112111111
112211111111111111111111112111
111121111212121111111111112111
111111111111111211111111111111
111111112111111111111111121111
111111111111121111111111111121
211111111121111111111111111111
111111111111212111111111112111
111121121211111111111111111111
111111111211111111111111111211
111111111211111111122111111111
111211112111111111111111111121
111111111111111111112121112111
111111111211111111111211111111
111221111111111111211111111111
111211111111211121111111121121
111111111111211112111111111111
111111112111111111211111111111
111111111121111111111111111112
112121111111111112121111111111
111111111111111111211111111111
111111111111111111111111112111
211111112111111111111122111111
