111111111111111111111111
1p0000000c00111111100001
1000000000001c0000000001
1000c1000000111111100001
100001100000000000000001
10000110000000c000000001
100001000010000000000c01
100000000110100001111111
1000000011111110000000e1
111111111111111111111111