111111111111111111111111
1P0000000C00111111100001
1000000000001C0000000001
1000C1000000111111100001
100001100000000000000001
10000110000000C000000001
100001000010000000000C01
100000000110100001111111
1000000e11111110000000E1
111111111111111111111111