11111111111111
1000100c00p001
100000010000c1
10000011100001
1c0001111100e1
11111111111111