1111111111111111
1000000000000001
1000000000000000
1111111111111111
